E0;E1;E0;E0;E0;E0;E0;E0;E0;E0;E1;E1;E0;E0;E0;E0;E0;E0;E0;E0;E1
E0;E0;E0;E1;E0;E0;E0;E0;E1;E0;E0;E1;E0;E0;E0;E0;E0;E0;E0;E0;E1
E0;E0;E0;E0;E0;E0;E0;E0;E0;E0;E0;E1;E0;E0;E0;E0;E0;E0;E0;E0;E1
E0;E1;E0;E0;E0;E0;E0;E0;E0;E0;E0;E1;E0;E0;E0;E0;E0;E0;E0;E0;E1
E0;E0;E0;E0;E1;E0;E0;E1;E0;E1;E0;E1;E0;E0;E0;E0;E0;E0;E0;E0;E1
E0;E0;E0;E0;E0;E0;E0;E0;E0;E0;E0;E1;E0;E0;E0;E0;E0;E0;E0;E0;E1
E0;E1;E0;E0;E0;E0;E0;E0;E0;E0;E1;E1;E0;E0;E0;E0;E0;E0;E0;E0;E1
E0;E0;E0;E1;E0;E0;E0;E0;E1;E0;E0;E1;E0;E0;E0;E0;E0;E0;E0;E0;E1
E0;E0;E0;E0;E0;E0;E0;E0;E0;E0;E0;E1;E0;E0;E0;E0;E0;E0;E0;E0;E1
E0;E1;E0;E0;E0;E0;E0;E0;E0;E0;E0;E1;E0;E0;E0;E0;E0;E0;E0;E0;E1
E0;E0;E0;E0;E1;E0;E0;E1;E0;E1;E0;E1;E0;E0;E0;E0;E0;E0;E0;E0;E1
E0;E0;E0;E0;E0;E0;E0;E0;E0;E0;E0;E1;E0;E0;E0;E0;E0;E0;E0;E0;E1
E0;E1;E0;E0;E0;E0;E0;E0;E0;E0;E1;E1;E0;E0;E0;E0;E0;E0;E0;E0;E1
E0;E0;E0;E1;E0;E0;E0;E0;E1;E0;E0;E1;E0;E0;E0;E0;E0;E0;E0;E0;E1
E0;E0;E0;E0;E0;E0;E0;E0;E0;E0;E0;E1;E0;E0;E0;E0;E0;E0;E0;E0;E1
E0;E1;E0;E0;E0;E0;E0;E0;E0;E0;E0;E1;E0;E0;E0;E0;E0;E0;E0;E0;E1
E0;E0;E0;E0;E1;E0;E0;E1;E0;E1;E0;E1;E0;E0;E0;E0;E0;E0;E0;E0;E1
E0;E0;E0;E0;E0;E0;E0;E0;E0;E0;E0;E1;E0;E0;E0;E0;E0;E0;E0;E0;E1